2,0,6,6,,
12,0,2,2,,66;216;110;120;163;169;204;205;111;80
14,0,6,6,,
16,0,6,6,,
18,0,6,6,,
20,0,6,6,,
22,0,6,6,,
24,0,6,6,,
30,0,6,6,,
32,0,6,6,,
33,0,2,2,,134;135
34,0,6,6,,
37,0,4,4,,138;139
38,0,6,6,,
39,0,4,4,,138;139
40,0,6,6,,
41,0,4,4,,138;139
42,0,6,6,,
51,0,6,6,,
53,0,6,6,,
56,0,6,6,,
88,0,6,6,,
112,0,6,6,,
117,0,6,6,,
119,0,6,6,,
121,0,4,4,,101;102;153;189
123,0,6,6,,
129,0,6,6,,
130,0,1,1,,35;36
131,0,6,6,,
132,0,1,1,,35;36
133,0,6,6,,
136,0,3,3,,43;44
137,0,6,6,,
140,0,5,5,,57;58
141,0,6,6,,
175,0,6,6,,
179,0,6,6,,
93,0,1,3,,186;187;94;92;118;128
91,0,1,3,,186;187;94;92;118;128
207,0,1,1,,64;165;167
6,0,1,1,,167
157,0,1,1,,64;165;167
4,0,1,1,,167
183,0,4,4,,3;184;5;156;206;63;166;182;65;66;164;61
152,0,1,1,,11;49;189;99;100;52;54;153
188,0,1,1,,11;49;189;99;100;52;54;153
47,0,3,5,,48;26;124;28;46;142;143;126
25,0,1,3,,125
27,0,1,3,,125
127,0,2,4,,45
161,0,3,4,,177;197
9,0,2,3,,159
84,0,1,2,,77;149;171;208;209;83;174;178;50;68;70;102;103;202;203
78,0,1,2,,77;149;171;208;209;83;174;178;50;68;70;102;103;202;203
79,0,2,2,,111;80;66;216;110;120;163;169;204;205
217,0,2,2,,111;80;66;216;110;120;163;169;204;205
151,0,1,2,,7;81;82;158;160;59;60;154;150;8;10;72;21;29;98;214;17;23;109;143
155,0,1,2,,7;81;82;158;160;59;60;154;150;8;10;72;21;29;98;214;17;23;109;143
196,0,1,2,,177;71;197;81;82;158;160;59;60;154;150;8;10;72;21;29;98;214;17;23;109;143
176,0,1,2,,177;71;197;81;82;158;160;59;60;154;150;8;10;72;21;29;98;214;17;23;109;143
108,0,1,2,,97;81;82;158;160;59;60;154;150;8;10;72;21;29;98;214;17;23;109;143
199,0,1,2,,97;81;82;158;160;59;60;154;150;8;10;72;21;29;98;214;17;23;109;143
215,0,1,2,,97;81;82;158;160;59;60;154;150;8;10;72;21;29;98;214;17;23;109;143
198,0,1,2,,97;81;82;158;160;59;60;154;150;8;10;72;21;29;98;214;17;23;109;143
85,0,2,2,,76;194;172;73;74;55;57;86;87;92;94;211;105;181;15;31;193;200;201;186;190;191;116;122;145;147;13;19;107;59;81;212
75,0,2,2,,76;194;172;73;74;55;57;86;87;92;94;211;105;181;15;31;193;200;201;186;190;191;116;122;145;147;13;19;107;59;81;212
90,0,1,1,,95;89;76;194;172;73;74;55;57;86;87;92;94;211;105;181;15;31;193;200;201;186;190;191;116;122;145;147;13;19;107;59;81;212
96,0,1,1,,95;89;76;194;172;73;74;55;57;86;87;92;94;211;105;181;15;31;193;200;201;186;190;191;116;122;145;147;13;19;107;59;81;212
192,0,1,1,,104;76;194;172;73;74;55;57;86;87;92;94;211;105;181;15;31;193;200;201;186;190;191;116;122;145;147;13;19;107;59;81;212
210,0,1,1,,104;76;194;172;73;74;55;57;86;87;92;94;211;105;181;15;31;193;200;201;186;190;191;116;122;145;147;13;19;107;59;81;212
180,0,1,1,,104;76;194;172;73;74;55;57;86;87;92;94;211;105;181;15;31;193;200;201;186;190;191;116;122;145;147;13;19;107;59;81;212
195,0,1,1,,106;76;194;172;73;74;55;57;86;87;92;94;211;105;181;15;31;193;200;201;186;190;191;116;122;145;147;13;19;107;59;81;212
213,0,1,1,,106;76;194;172;73;74;55;57;86;87;92;94;211;105;181;15;31;193;200;201;186;190;191;116;122;145;147;13;19;107;59;81;212
173,0,1,1,,106;76;194;172;73;74;55;57;86;87;92;94;211;105;181;15;31;193;200;201;186;190;191;116;122;145;147;13;19;107;59;81;212
11,1,6,6,152;188,
35,1,2,2,130;132,134;135
36,1,6,6,130;132,
49,1,6,6,152;188,
52,1,6,6,152;188,
54,1,6,6,152;188,
99,1,6,6,152;188,
100,1,2,2,152;188,66;216;110;120;163;169;204;205;111;80
118,1,6,6,93;91,
128,1,6,6,93;91,
187,1,6,6,93;91,
64,1,3,3,207;157,185
167,1,2,2,207;6;157;4,62
165,1,2,2,207;157,62
77,1,2,3,84;78,149;171;208;209;83;174;178;50;68;70;102;103;202;203
125,1,2,4,25;27,45
7,1,2,3,151;155,159
71,1,2,3,196;176,159
97,1,2,3,108;199;215;198,159
95,1,2,2,90;96,76;194;172;73;74;55;57;86;87;92;94;211;105;181;15;31;193;200;201;186;190;191;116;122;145;147;13;19;107;59;81;212
106,1,2,2,195;213;173,76;194;172;73;74;55;57;86;87;92;94;211;105;181;15;31;193;200;201;186;190;191;116;122;145;147;13;19;107;59;81;212
89,1,2,2,90;96,76;194;172;73;74;55;57;86;87;92;94;211;105;181;15;31;193;200;201;186;190;191;116;122;145;147;13;19;107;59;81;212
104,1,2,2,192;210;180,76;194;172;73;74;55;57;86;87;92;94;211;105;181;15;31;193;200;201;186;190;191;116;122;145;147;13;19;107;59;81;212
50,2,6,6,77;84;78,
83,2,3,4,77;84;78,114;115
103,2,6,6,77;84;78,
134,2,3,3,33;35,43;44
135,2,6,6,33;35,
149,2,6,6,77;84;78,
171,2,6,6,77;84;78,
174,2,6,6,77;84;78,
178,2,6,6,77;84;78,
203,2,6,6,77;84;78,
209,2,6,6,77;84;78,
62,2,3,3,167;165,185
80,2,3,3,12;100;79;217,66;216;110;120;163;169;204;205
111,2,3,3,12;100;79;217,66;216;110;120;163;169;204;205
45,2,3,5,125;127,48;26;124;28;46;142;143;126
159,2,3,4,7;71;97;9,177;197
194,2,3,3,95;106;89;85;75;104;90;96;192;210;180;195;213;173,73;74;55;57;86;87;92;94;211;105;181;15;31;193;200;201;186;190;191;116;122;145;147;13;19;107;59;81;212
76,2,3,3,95;106;89;85;75;104;90;96;192;210;180;195;213;173,73;74;55;57;86;87;92;94;211;105;181;15;31;193;200;201;186;190;191;116;122;145;147;13;19;107;59;81;212
172,2,3,3,95;106;89;85;75;104;90;96;192;210;180;195;213;173,73;74;55;57;86;87;92;94;211;105;181;15;31;193;200;201;186;190;191;116;122;145;147;13;19;107;59;81;212
13,3,6,6,194;76;172;95;106;89;85;75;104;90;96;192;210;180;195;213;173,
15,3,6,6,194;76;172;95;106;89;85;75;104;90;96;192;210;180;195;213;173,
19,3,6,6,194;76;172;95;106;89;85;75;104;90;96;192;210;180;195;213;173,
26,3,6,6,47;45,
28,3,6,6,47;45,
31,3,6,6,194;76;172;95;106;89;85;75;104;90;96;192;210;180;195;213;173,
43,3,4,4,134;136,138;139
44,3,6,6,134;136,
46,3,6,6,47;45,
48,3,6,6,47;45,
55,3,6,6,194;76;172;95;106;89;85;75;104;90;96;192;210;180;195;213;173,
73,3,6,6,194;76;172;95;106;89;85;75;104;90;96;192;210;180;195;213;173,
74,3,6,6,194;76;172;95;106;89;85;75;104;90;96;192;210;180;195;213;173,
86,3,4,4,194;76;172;95;106;89;85;75;104;90;96;192;210;180;195;213;173,138;139
87,3,6,6,194;76;172;95;106;89;85;75;104;90;96;192;210;180;195;213;173,
92,3,4,4,93;91;194;76;172;95;106;89;85;75;104;90;96;192;210;180;195;213;173,138;139
94,3,4,4,93;91;194;76;172;95;106;89;85;75;104;90;96;192;210;180;195;213;173,138;139
105,3,6,6,194;76;172;95;106;89;85;75;104;90;96;192;210;180;195;213;173,
107,3,6,6,194;76;172;95;106;89;85;75;104;90;96;192;210;180;195;213;173,
110,3,6,6,12;100;80;111;79;217,
114,3,4,5,83,67;68
115,3,6,6,83,
116,3,6,6,194;76;172;95;106;89;85;75;104;90;96;192;210;180;195;213;173,
120,3,6,6,12;100;80;111;79;217,
122,3,6,6,194;76;172;95;106;89;85;75;104;90;96;192;210;180;195;213;173,
145,3,6,6,194;76;172;95;106;89;85;75;104;90;96;192;210;180;195;213;173,
147,3,6,6,194;76;172;95;106;89;85;75;104;90;96;192;210;180;195;213;173,
163,3,6,6,12;100;80;111;79;217,
169,3,6,6,12;100;80;111;79;217,
181,3,5,5,194;76;172;95;106;89;85;75;104;90;96;192;210;180;195;213;173,57;58
186,3,6,6,93;91;194;76;172;95;106;89;85;75;104;90;96;192;210;180;195;213;173,
190,3,6,6,194;76;172;95;106;89;85;75;104;90;96;192;210;180;195;213;173,
191,3,6,6,194;76;172;95;106;89;85;75;104;90;96;192;210;180;195;213;173,
193,3,5,5,194;76;172;95;106;89;85;75;104;90;96;192;210;180;195;213;173,57;58
201,3,6,6,194;76;172;95;106;89;85;75;104;90;96;192;210;180;195;213;173,
205,3,4,4,12;100;80;111;79;217,101;102;153;189
211,3,6,6,194;76;172;95;106;89;85;75;104;90;96;192;210;180;195;213;173,
185,3,4,4,62;64,3;184;5;156;206;63;166;182;65;66;164;61
177,3,4,5,161;159;196;176,81;82;158;160;59;60;154;150;8;10;72;21;29;98;214;17;23;109;143
197,3,4,5,161;159;196;176,81;82;158;160;59;60;154;150;8;10;72;21;29;98;214;17;23;109;143
3,4,6,6,183;185,
5,4,6,6,183;185,
8,4,6,6,177;197;151;155;196;176;108;199;215;198,
10,4,6,6,177;197;151;155;196;176;108;199;215;198,
17,4,6,6,177;197;151;155;196;176;108;199;215;198,
21,4,6,6,177;197;151;155;196;176;108;199;215;198,
23,4,6,6,177;197;151;155;196;176;108;199;215;198,
29,4,6,6,177;197;151;155;196;176;108;199;215;198,
59,4,6,6,177;197;194;76;172;151;155;196;176;108;199;215;198;95;106;89;85;75;104;90;96;192;210;180;195;213;173,
60,4,6,6,177;197;151;155;196;176;108;199;215;198,
61,4,6,6,183;185,
63,4,6,6,183;185,
65,4,6,6,183;185,
66,4,6,6,183;185;12;100;80;111;79;217,
67,4,6,6,114,
68,4,6,6,114;77;84;78,
72,4,6,6,177;197;151;155;196;176;108;199;215;198,
81,4,6,6,177;197;194;76;172;151;155;196;176;108;199;215;198;95;106;89;85;75;104;90;96;192;210;180;195;213;173,
82,4,6,6,177;197;151;155;196;176;108;199;215;198,
98,4,6,6,177;197;151;155;196;176;108;199;215;198,
101,4,6,6,121;205,
102,4,6,6,121;205;77;84;78,
109,4,6,6,177;197;151;155;196;176;108;199;215;198,
138,4,5,5,37;39;41;43;86;92;94,57;58
139,4,6,6,37;39;41;43;86;92;94,
143,4,6,6,47;45;177;197;151;155;196;176;108;199;215;198,
153,4,5,5,121;205;152;188,69;70
156,4,5,5,183;185,1;113;124;126;142;144;146;148;150;154;158;160;162;164;166;168;170;182;184;200;202;204;208;212;214;216
189,4,5,5,121;205;152;188,69;70
206,4,5,5,183;185,1;113;124;126;142;144;146;148;150;154;158;160;162;164;166;168;170;182;184;200;202;204;208;212;214;216
1,5,6,6,156;206,
57,5,6,6,138;140;181;193;194;76;172;95;106;89;85;75;104;90;96;192;210;180;195;213;173,
58,5,6,6,138;140;181;193,
69,5,6,6,153;189,
70,5,6,6,153;189;77;84;78,
113,5,6,6,156;206,
124,5,6,6,156;206;47;45,
126,5,6,6,156;206;47;45,
142,5,6,6,156;206;47;45,
144,5,6,6,156;206,
146,5,6,6,156;206,
148,5,6,6,156;206,
150,5,6,6,156;206;177;197;151;155;196;176;108;199;215;198,
154,5,6,6,156;206;177;197;151;155;196;176;108;199;215;198,
158,5,6,6,156;206;177;197;151;155;196;176;108;199;215;198,
160,5,6,6,156;206;177;197;151;155;196;176;108;199;215;198,
162,5,6,6,156;206,
164,5,6,6,156;206;183;185,
166,5,6,6,156;206;183;185,
168,5,6,6,156;206,
170,5,6,6,156;206,
182,5,6,6,156;206;183;185,
184,5,6,6,156;206;183;185,
200,5,6,6,156;206;194;76;172;95;106;89;85;75;104;90;96;192;210;180;195;213;173,
202,5,6,6,156;206;77;84;78,
204,5,6,6,156;206;12;100;80;111;79;217,
208,5,6,6,156;206;77;84;78,
212,5,6,6,156;206;194;76;172;95;106;89;85;75;104;90;96;192;210;180;195;213;173,
214,5,6,6,156;206;177;197;151;155;196;176;108;199;215;198,
216,5,6,6,156;206;12;100;80;111;79;217,
